┌─ Output ─────────────────────────────────────────────────────────────────────┐
│val result: int = 99                                                          │
│[error] Type mismatch                                                         │
│                                                                              │
│                                                                              │
│                                                                              │
│                                                                              │
│                                                                              │
│                                                                              │
│                                                                              │
│                                                                              │
│                                                                              │
│                                                                              │
│                                                                              │
│                                                                              │
│                                                                              │
│                                                                              │
│                                                                              │
│                                                                              │
│                                                                              │
│                                                                              │
│                                                                              │
├──────────────────────────────────────────────────────────────────────────────┤
├─ Editor ─────────────────────────────────────────────────────────────────────┤
│let result = 99                                                               │
│                                                                              │
│                                                                              │
│                                                                              │
└──────────────────────────────────────────────────────────────────────────────┘
Focused                                                                 One Dark