┌─ Output ─────────────────────────────────────────┐┌─ Sessions ───────────────┐
│val x: int = 42                                   ││abc123 [Ready] * (MyProj.f│
│val y: string = "hello"                           ││def456 [WarmingUp] (Tests.│
│[info] Loaded 3 files                             ││                          │
│                                                  ││                          │
│                                                  ││                          │
│                                                  ││                          │
│                                                  ││                          │
│                                                  ││                          │
│                                                  ││                          │
│                                                  ││                          │
│                                                  ││                          │
│                                                  ││                          │
│                                                  ││                          │
│                                                  ││                          │
│                                                  ││                          │
│                                                  ││                          │
│                                                  ││                          │
│                                                  ││                          │
│                                                  ││                          │
│                                                  ││                          │
│                                                  ││                          │
├──────────────────────────────────────────────────┤│                          │
├─ Editor ─────────────────────────────────────────┤│                          │
│let x = 1                                         ││                          │
│let y = "hello"                                   ││                          │
│printfn "%d" x                                    ││                          │
│                                                  ││                          │
└──────────────────────────────────────────────────┘└──────────────────────────┘
Session: abc123                                                         One Dark